# Greek	# temporary substitude character
α	ḁ
β	ḇ
χ	ƈ
δ	ɖ
Δ	Ḏ
ε	ḙ
η	ḛ
φ	ḟ
Φ	Ḟ
γ	ɠ
Γ	Ɠ
ι	ḭ
κ	ƙ
λ	ḻ
Λ	Ḻ
µ	ṃ
ν	ŋ
ω	ọ
Ω	Ọ
π	ṕ
Π	Ṕ
ψ	ṗ
Ψ	Ṗ
ρ	ṟ
σ	ṣ
ς	ṩ
Σ	Ṣ
τ	ṱ
θ	ṯ
Θ	Ṯ
υ	ṵ
ξ	ȥ
Ξ	Ȥ
ζ	ȥ
